EA ./path_to_the_east_texture
NO ./path_to_the_north_texture
SO ./path_to_the_south_texture
WE path_to_the_west_texture

F 110, 220, 0
C 135, 206, 235

     111111111111111111111111111
11111100000000010000000000000111
1101100000111000N00000000111111
111001000000000010000000001
111111111111111111111111111