EA assets/tile000.xpm
NO assets/tile001.xpm
SO assets/tile002.xpm
WE assets/////tile003.xpm

F 110, 220,10
C 0,0,0


11111111111111111111111111111111111
110110000011100000000001111111
101001000000000010000001N1
111111111111111111111111111111
