EA ./path_to_the_east_texture
NO ./path_to_the_north_texture
SO ./path_to_the_south_texture
WE path_to_the_west_texture

F 50, 70, 10
C 50, 70, 90

     111111111111111111111111111
11111100000000010000000000000111
1101100000111000N00000000111111
11100100000000001000000001
111111111111111111111111111