EA assets/xpm.xpm
NO assets/xpm1.xpm     
SO assets/xpm2.xpm
WE assets/xpm3.xpm
F  55,00,44
C  10, 20, 100

   11111111111111111111
111111111100000W0000001
11111111110000000000001
11111111110000000000001
1111111111111111111111