                                          EA                                                                assets/tile000.xpm

                        NO assets/tile001.xpm









                                       SO assets/tile002.xpm
  WE assets/tile003.xpm
                                                                              F  55,00,                                                             44


                                           C         10, 20, 100
                          11111111111111111111111111111111
                111111111100000W0000001
                1111111111111111111111
1
11111 11111111111
1              1
 11111111111              
1111111111

