                                          EA                                                                assets/tile000.xpm

NO assets/tile001.xpm
C 10, 220, 100
















                                                                      F 0, 20, 100








SO assets/tile002.xpm
WE assets/tile003.xpm


 111111111111111111111111111111111
                1111111111W11
11111111111111111 1111111111111111