NO game_textures/xpm.xpm
SO game_textures/xpm1.xpm
WE game_textures/xpm2.xpm
EA game_textures/xpm3.xpm

C 59, 84, 84
F 83, 60, 60
        1111111111111111111111111
        1000000000110000000000001
        1011000001110000000000001
        1001000000000000000000001
111111111011000001110000000000001
100000000011000001110110001111111
11110111111111011100000010001
11110111111111011101010010001
11000000110101011100000010001
10000000000000001100000010001
10000000000000001101010010001
11000001110101011111011110W0111
11110111 1110101 101111010001
11111111 1111111 111111111111
